1111111111111111111111111111111
1P00000000110000000000001111111
1011000001110000000000001111111
1001000000000000000000001111111
1111111110110000011100000000011
1000000000110000011101111101111
1111011111111101110000001000111
1111011111111101110101001000111
1100000011010101110000001000111
1000000000000000000000001000111
1000000000000000110101001000111
11000001110101011111011110N0111
1111011101110101010111101000111
1111111101111111011111111111111
