111111111
100000011
101000001
101000001  11111
1010S0001  10111 
101000001  11111
101110001 
100000001
111111111