111111111
100000011
101000001
101000001
1010P0001
101000001
101110001
100000001
111111111