R 1920 1080

NO ./textures/planks.xpm
SO ./textures/enemy1.xpm
WE ./textures/torch.xpm
EA ./textures/attack_torch.xpm

S ./textures/creeper.xpm
F 113,113,113
C 56,56,56

        111111111111111111111111
        100000000011000000000001
        101100000111000000000001
        100100000000000000000001
11111111101100000111000000000001
100000000011000001110111110111111
111101111111110111000000100011111111111111111111111111111
111101111111110111010100100011110111111111011100000010001
110000001101010111000000100011110111111111011100000010001
100000000000000011000000100000000000000000011000000100001
100000000000000011010100100000000000000000011000000100001
11101111111110111000000100000000S000000000110000001000001
111101111111110111010100100000000000000000011000000100001
110000001101010111000000100000000000000000011000000100001
100000000000000011000000100000000000000000011000000100001
100000000000000011010100100000000000000000011000000100001
111011111111101110000001000011111111111111111111111111111
11110111111111011101010010001
11000000110101011100000010001
10000000000000001100000010001
10000000000000001101010010001
11101111111110111000000100011
11110111111111011101010010001
11000000110101011100000010001
10000000000000001100000010001
10000000000000001101010010001
11101111111110111000000100011
11110111111111011101010010001
11000000110101011100000010001
10000000000000001100000010001
10000000000000001101010010001
11000001110101011111011110011
11110111 1110101 101111010001
11111111 1111111 111111111111