EA ./textures/128-png/002.png
WE ./textures/128-png/014.png
SO ./textures/128-png/050.png
NO ./textures/128-png/012.png

CU ./sprites/character/u/
CD ./sprites/character/d/
CL ./sprites/character/l/
CR ./sprites/character/r/

F 113,113,113
C 56,56,56

1111111111111111111111111111111111111111111111111111111111111111111111
1100000000000000000000000000110000001100000000000000000000000000000011
1111110011111111111111111100110011001111110011001100111111001111110011
1100000000000000110000001100110011001100000011001100110000001100000011
1100111111111100110011001100110011001100111111001100110011001100110011
1100000000001100110011001100000011001100110000001100110011001100110011
1111111111001100110011111100111111001100110011111111110011001100111111
1100000011001100110000001100000011000000110000000000110011001100000011
1100111111001100111111001100110011111111111111111100110011001111110011
1100000011001100000011001100110000000000000000001100110011000000110011
1100110011001100110011001111111111111111111111001100110011111111110011
1100110000001100110011001100000000000000000011001100110000000000110011
1111111111111111110011001100111111111111110011001100111111001100111111
11000000000000000000110011001100000W0000110011001100000011001100000011
1100111111111111111111001111110011001100110011001111110011001111110011
1100000000000000000000001100000011001100110000001100000011001100000011
1100111111111111111111001100111111111100111111111100111111001100111111
1100000000000000000011001100000000001100000000000000110000001100110011
1100111111111111110011001111111111001111111111111111110011001100110011
1100110000001100000011000000110011000000000000001100000011001100000011
1111110011001100111111001100110011001111111111001100111111111111111111
1100000011001100000011001100000011000000000011001100110000001100000011
1100111111001111110011111111110011111111111111001100110011001100111111
1100000011000000110011000000110000000000110000001100000011001100000011
1100110011111100110011001100111111111100110011001111111111001111110011
1100110000001100110011001100000011000000110011000000000011000000110011
1111111111001100110011111111110011001111110011111100110011001100110011
1100000000001100110000000000110011001100110000001100110011001100000011
1100111111111100110011111100110011001100111111001100110011111111111111
1100000011000000110000001100110011000000110000001100110011000000000011
1111111111001111111111111100110011111111110011111D00110011001111110011
1100000000001100000000001100000011000000110000001100110011001100000011
1100111111111100110011001111111111001100111111001100110011001100111111
1100000000000000110011000000000000001100000000001100110000001100000011
1111111111111111111111111111111111111111111111111111111111111111111111
