EA ./textures/128-png/002.png
WE ./textures/128-png/014.png
SO ./textures/128-png/050.png
NO ./textures/128-png/008.png

F 113,113,113
C 56,56,56

1111111111111111111111111111111111111111111111111111111111111111
1111111111111111111111111111111111111111111111111111111111111111
1111111111111111111111111111100000000000111111111111111111111111
1111110000111111111111111111100000000000111111111111111111111111
1111110000111111110000000000100000000000100011111111111111111111
1111110000011111110000000000000000000000001011111111111111111111
1111110000011111110000000000100000000000100011111111111111111111
1111111011111111110001111111100000000000111111111111111111111111
1111110000000001110001111111100000000000111111111111111111111111
1111110000000001110001111111111111011111111111111111111111111111
1111110000000001000000011111111110001111111111111111111111111111
1111110000000000000000011111111110001111111111111111111111111111
1111110000000001000000011111111110001111111111111111111111111111
1111110000000001111111111111111110001111111111111111111111111111
1000110000000001111111111111111110001111111111111111111111111111
1000111111011111111111111111111110001111111111111111111111111111
1000111110001111111111111111000000000011111111111111111111111111
1101111110001111111111111111001110001111111111111111111111111111
1000111110001111111111111111001110001111111111111111111111111111
1000100010001111111111111111001110001111111111111111111111111111
1000000010001111111111111111111110001111111111111111111111111111
1000100010001111111111111111111110001111111111111111111111111111
1000111111011111111111111111111111011111111111111111111111111111
1000110000000001111111111111111100000111111111111111110000000011
1000110000000001111111111110000000000000001111111111110000000011
1000110000000001111111111110000000000000001111111111110000000011
1000010000000001111111111110000000000000000100000000010000000011
1000000000000001111111111110000000000000000000000000000000000011
1000010000000001111111111110000000000000000100000000010000000011
1000110000000001111111111110000000000000001111000011110000000011
1000110000000001111111111110000000000000001111100111110000000011
1000110000000001111111111111111100000111111111100111110000000011
1000111111011111111111111111111111011111111111100111111101101111
1000111110001111111111111111111110001111111111100111111111111111
1000111110001111111111111111111110001111111111100111111111111111
1000100010001111111111111111111110001111111111100111111111111111
1000000010001111111111111111111110001111111111100111010101011111
1000100010001111111111111111111110001111111111100010000000001111
1000111110001111111111111111111110001111111111100000000000001111
1000111110001111111111111111111110001111111111100010000000001111
1000000000000000010000001111111110001111111111111111010101011111
1000000000000000000000001111111110001111111111111111111111111111
1000000000000000010000011111111110001111111111111111111111111111
1111111111110111111111111111111110001111111111111111111111111111
1111111111110010011111111111111111011111111111111111111111111111
1111111111110010011111111111000010001000011111111111111111111111
1111111111110000011111111111000000000000011111111111111111111111
1111111111111111111111111111000010001000011111111111111111111111
1111111111111111111111111111000010001000011111111111111111111111
1111111111111111111111111111111110001111111111111111111111111111
1111111111111111111111111111000010001000011111111111111111111111
11111111111111111111111111110E0000000000011111111111111111111111
1111111111111111111111111111000010001000011111111111111111111111
1111111111111111111111111111111110001111111111111111111111111111
1111111111111111111111111111000000000000011111111111111111111111
1111111111111111111111111111000000000000011111111111111111111111
1111111111111111111111111111000000000000011111111111111111111111
1111111111111111111111111111111111111111111111111111111111111111
